15
###############
#         #   #
######### # # #
# #   CCC # # #
# # #######%# #
# # #&    X # #
# # # ####### #
#   # CC#   # #
# #####%# #@# #
# #%    # #   #
# ####### #####
#       # %   #
####### ##### #
#             #
###############