15
###############
# #     %     #
# # ### # ### #
# # #   X #   #
# #C####### ###
# #CC%# CC#   #
# ### # #@### #
#     # #     #
#######&#######
#%#   # #     #
# # # # # ### #
# # # # # #   #
# # # # # # ###
#   #     #   #
###############