18
##################
# #             ##
# ############# ##
# #     CC    # ##
# #%######### # ##
# # #   #   # # ##
# # ##@ # # # #X##
# # #  %# #   # ##
# # #C### #####%##
#   #C#   # CCCC##
#####C# ####### ##
#   # & #     # ##
### # ##### # # ##
#   # #     # # ##
# ### ### ### # ##
#  C C    #     ##
##################
##################