22
######################
# C   # C  %C   #  C##
# ### # ####### # ####
# # # #    %  # # C ##
# # # ####### #C###C##
# #     #   # #   # ##
#C# ##### # # ### # ##
#%#   #   #   #     ##
# ###C# #######%######
# #   # #     # #   ##
# ### #C# ###C# # # ##
#C  # #%#  C# # C # ##
# # ### ##### ##### ##
# #   # #  X# C #  C##
# ### #&### # # # ####
#   #C#CC #   # C # ##
### # ### # #%#####C##
#  @#   #C  #   #   ##
# ### ######### #%# ##
#   #%       C    # ##
######################
######################