18
##################
#C#   #   #     ##
#C# # # ### # ####
#C%C# # #   #   ##
##### # # ##### ##
# #   #   #   # ##
# # ##### # ### ##
#   #   #   #   ##
# ### # ##### # ##
# #   #%& CCCC# ##
# @ # ### ##### ##
# # # %     # # ##
# ######### # # ##
#CC   #   # #CCC##
##### # # # # ####
#   X   #   #   ##
##################
##################