20
####################
# #       #       ##
# # ##### # ##### ##
#   #   # #     #X##
##### ### ##### # ##
#       #%#   # # ##
# ##### # # # # ####
# #C#   #   #C# & ##
# #C# #######C### ##
# CC#   %   #CCCC ##
###C####### ##### ##
# #%  #C   %    # ##
# # ###C######### ##
#   #  C#C%     # ##
# ### ###C#####C# ##
# # # CC C@%  #CC ##
# # ####### # ######
#   CCC     #     ##
####################
####################
