18
##################
# #   #   #     ##
# # # # ### # ####
#   # # #   #   ##
##### # # ##### ##
# #   #   #   # ##
# # ##### # ### ##
#   #   #   #   ##
# ### # ##### # ##
# #   #%&%    # ##
# @ # ######### ##
# # # %     # # ##
# ######### # # ##
#     #   # #CCC##
##### # # # # ####
#   X   #   #   ##
##################
##################