18
##################
# #             ##
# ############# ##
# #           # ##
# #%######### # ##
# # #   #   # # ##
# # ##@ # # # #X##
# # #  %# #   # ##
# # #C### #####%##
#   #C#   #     ##
#####C# ####### ##
#   # & #     # ##
### # ##### # # ##
#   # #     # # ##
# ### ### ### # ##
#         #     ##
##################
##################